11111111111111111111111111111111
10P00111000000000000100000101C01
10010000011001110110110110100011
11010111111100010110110100101011
11010001001001010010100101101001
10011101011011011010001100101111
10100001000001011011100010100011
10101111111111001000111110111001
1000110000000C101010000010001101
11110001111111100001111011100101
10010101000000C11101000010110101
11010100010101111001110110010101
10010111100101000011100110110001
10110110001100011110000000111011
10010100111111111000111110100011
11010101000000010010010000101001
10000101110111011111011101101101
1010110000000100000101C0010011C1
1E11101111011000110C101111111101
11111111111111111111111111111111
